===###====
==##=#=###
=##==###==
##========
#==#=#=#==
######=#==
==#==#====
=##=##=#=#
=#==##==##
=#=====###